..........W........R
A...W....###........
+++++++...1.........
r.........W......S.X
C...W.....W......###
+++++++...W.........
..........W........R
..C.W.....W.........
+++++++...W..W....C.
..........W..+++++++
r..CW.....W.........
+++++++...W..W.....C
..........W..+++++++
..........W........R
..@@@@@@@@@@@@@@@@..
50
Six levels of hot flames...